I                                                                                                                 I                   
C                                                                                                                 C                   
C                                                                                                                 C                   
C                                                                                                                 C                   
C                                                                                                                 C                   
C                                                                                                                 C                   
C                                                                                                                 C                   
C                                                                                                                 C                   
C                                                                                                                 C                   
C                                                                                                                 C                   
C                                                                                             a                   C                   
C                         a                                                                  aaa                  C                   
C                       a   a                                                               aaaaa                 C                   
C                     a       a            BBB              2                              BBBBBBB                C                   
C                   BBB       BBB       1  AAA                                             AAAAAAA                C                   
C                   AAA   0   AAA     BBBBBAAA   BBB                            e  3       AAAAAAA   s     1   g  C                   
FBBBBBBBBBBBBBBBBG  AAAABBBBAAAAA   FBAAAAAAAAG FBAAAAABG   FBAAAAABG         FBBBBBBBBG   AAAAAAA FBBBBBBBBBBBBBBG                   
AAAAAAAAAAAAAAAAAA  AAAAAAAAAAAAA   AAAAAAAAAAA AAAAAAAAA   AAAAAAAAA         AAAAAAAAAA   AAAAAAA AAAAAAAAAAAAAAAA                   
AAAAAAAAAAAAAAAAAA  AAAAAAAAAAAAA   AAAAAAAAAAA AAAAAAAAA   AAAAAAAAA         AAAAAAAAAA   AAAAAAA AAAAAAAAAAAAAAAA