I                                                                                                  L
C                                                                                                  M
C                                                                                                  M
C                                      a   a                                                       M
C                                    a       a                       e                             M
C                                  a           a                                                   M
C                                                      KDDDDDDDDDDDDDDJ                            M
C                a                                                                                 M
C              a   a                             2                              s                  M
C            a       a                                                      KDDDDJ                 M
C          KDDDDDDDDDDDJ                                                                           M
C                                        a   a                                                     M
C                              1       a       a                                                   M
C                            KDDDJ   a           a             2                                   M
C                                                                                                  M
C      b                                              KDDDDDDDDDDJ                                 M
C    KDDDJ                                                                                         M
C                                                                                                  M
C                  a   a                                     a                                     M
C                a       a                                 a   a                  1   1            M
C              a           a                             a       a              KDDDDDDDJ          M
C                                                      a           a                               M
C    a 0 a         a1 1a         a 3 a       a 0 a                                   a 3 a         M
FBBBBBBBBBBBBBBBBBBBBBBBBBBBBBBBBBBBBBBBBBBBBBBBBBBBBBBBBBBBBBBBBBBBBBBBBBBBBBBBBBBBBBBBBBBBBBBBBBBG
AAAAAAAAAAAAAAAAAAAAAAAAAAAAAAAAAAAAAAAAAAAAAAAAAAAAAAAAAAAAAAAAAAAAAAAAAAAAAAAAAAAAAAAAAAAAAAAAAAAA